%%%%%%%%%%%%%%%%%%%%
--&&-&---&&&--&&--&-
---@@@--@--@-@@---@-
%%%%%%%%%%%%%%%%%%%%
#C####C####C###C####
####C##C####C##C##C#
%%%%%%%%%H%%%%%%%%%%