%%%%%%%%%%%%%%%%%%%%
--&&-&---&&&--&&--&-
---@@@--@--@-@@---@-
%%%%%%%%%%%%%%%%%%%%
#C####C#A##C###C##A#
A###A##C#A##C##C##C#
%%%%%%%%%H%%%%%%%%%%